Parasite	'Comedy', 'Drama', 'Thriller'	'Amazon Instant Video', 'iTunes', 'Google Play', 'Hulu'
E.T. the Extra-Terrestrial	'Family', 'Sci-Fi'	'VuduIVAUS', 'iTunes', 'Amazon Instant Video', 'Google Play', 'Netflix'
Back to the Future	'Adventure', 'Comedy', 'Sci-Fi'	'VuduIVAUS', 'Netflix', 'iTunes', 'Amazon Instant Video', 'Google Play'
Marriage Story	'Comedy', 'Drama', 'Romance'	'Netflix'
Indiana Jones and the Raiders of the Lost Ark	'Action', 'Adventure'	'Amazon Instant Video', 'Google Play', 'iTunes', 'VuduIVAUS', 'Netflix'
Cape Fear	'Crime', 'Thriller'	'Google Play', 'iTunes', 'Amazon Instant Video', 'VuduIVAUS'
Zodiac	'Crime', 'Drama', 'Mystery', 'Thriller'	'iTunes', 'Google Play', 'Amazon Instant Video', 'Amazon Prime Video', 'Netflix', 'VuduIVAUS'
Spider-Man: Into the Spider-Verse	'Animation', 'Action', 'Adventure', 'Family', 'Sci-Fi'	'Amazon Instant Video', 'iTunes', 'Google Play', 'Netflix', 'VuduIVAUS'
The Irishman	'Biography', 'Crime', 'Drama'	'Netflix'
Dolemite Is My Name	'Biography', 'Comedy', 'Drama'	'Netflix'
El Camino	'Short', 'Sci-Fi'
Million Dollar Baby	'Drama', 'Sport'	'Google Play', 'Amazon Instant Video', 'iTunes', 'Netflix', 'VuduIVAUS'
The Silence of the Lambs	'Crime', 'Drama', 'Thriller'	'iTunes', 'Amazon Instant Video', 'Google Play', 'Amazon Prime Video', 'VuduIVAUS'
Burning	'Drama', 'Mystery'	'iTunes', 'Google Play', 'Amazon Instant Video', 'VuduIVAUS', 'Netflix'
Roma	'Drama'	'Netflix'
Schindler's List	'Biography', 'Drama', 'History'	'Google Play', 'Amazon Instant Video', 'iTunes', 'VuduIVAUS', 'Netflix'
God's Own Country	'Drama', 'Romance'	'VuduIVAUS', 'Google Play', 'iTunes'
Monty Python and the Holy Grail	'Adventure', 'Comedy', 'Fantasy'	'Netflix', 'Google Play', 'Amazon Instant Video'
Inglourious Basterds	'Adventure', 'Drama', 'War'	'Amazon Instant Video', 'Google Play', 'iTunes', 'Netflix', 'VuduIVAUS'
Uncut Gems	'Crime', 'Drama', 'Thriller'	'iTunes', 'Google Play', 'Amazon Instant Video', 'VuduIVAUS', 'Netflix'
V for Vendetta	'Action', 'Drama', 'Sci-Fi', 'Thriller'	'VuduIVAUS', 'iTunes', 'Google Play', 'Amazon Instant Video', 'Netflix'
Her	'Drama', 'Romance', 'Sci-Fi'	'Netflix', 'Google Play', 'iTunes', 'Amazon Instant Video'
Honeyland	'Documentary', 'Drama'	'iTunes', 'Google Play', 'Amazon Instant Video', 'Hulu', 'VuduIVAUS'
Minding the Gap	'Documentary'	'Hulu'
Grave of the Fireflies	'Animation', 'Drama', 'War'	'VuduIVAUS', 'iTunes', 'Hulu'
Apollo 11	'Documentary', 'History'	'VuduIVAUS', 'iTunes', 'Google Play', 'Amazon Instant Video', 'Hulu'
Amazing Grace	'Biography', 'Drama', 'History', 'Romance'	'iTunes', 'Google Play', 'Amazon Instant Video', 'Amazon Prime Video', 'VuduIVAUS'
Portrait of a Lady on Fire	'Drama', 'Romance'	'VuduIVAUS', 'iTunes', 'Google Play', 'Hulu', 'AtomTicketsIVAUS'
Whose Streets?	'Documentary'	'iTunes', 'Google Play', 'Amazon Instant Video', 'Hulu'
Jane	'Documentary', 'Biography'	'VuduIVAUS', 'iTunes', 'Google Play', 'Amazon Instant Video', 'Disney+', 'Hulu'
The Cave	'Action', 'Adventure', 'Horror', 'Sci-Fi', 'Thriller'	'VuduIVAUS', 'Google Play', 'Amazon Instant Video'
Pick of the Litter	'Documentary'	'VuduIVAUS', 'iTunes', 'Google Play', 'Amazon Instant Video', 'Hulu'
Tangerine	'Comedy', 'Crime', 'Drama'	'VuduIVAUS', 'Google Play', 'Amazon Instant Video', 'Hulu', 'iTunes'
Escape from Alcatraz	'Biography', 'Crime', 'Drama', 'Thriller'	'VuduIVAUS', 'Google Play', 'iTunes', 'Amazon Instant Video', 'Hulu', 'Amazon Prime Video'
A Quiet Place	'Drama', 'Horror', 'Sci-Fi'	'iTunes', 'Google Play', 'Amazon Prime Video', 'Amazon Instant Video', 'Hulu', 'VuduIVAUS'
Hail Satan?	'Documentary'	'Amazon Instant Video', 'iTunes', 'Google Play', 'Hulu'
Dave	'Comedy', 'Romance'	'VuduIVAUS', 'Google Play', 'iTunes', 'Amazon Instant Video', 'Hulu'
The Dark Knight	'Action', 'Crime', 'Drama', 'Thriller'	'iTunes', 'Google Play', 'Amazon Instant Video', 'Hulu', 'VuduIVAUS'
March of the Penguins	'Documentary', 'Family'	'iTunes', 'Google Play', 'Amazon Instant Video', 'Hulu', 'VuduIVAUS'
RBG	'Documentary', 'Biography'	'Amazon Instant Video', 'iTunes', 'Google Play', 'Hulu', 'VuduIVAUS'
Moonstruck	'Comedy', 'Drama', 'Romance'	'Amazon Instant Video', 'Google Play', 'iTunes', 'Amazon Prime Video', 'Hulu', 'VuduIVAUS'
National Lampoon's Vacation	'Adventure', 'Comedy'	'HBOMaxIVAUS', 'iTunes', 'Google Play', 'Amazon Instant Video', 'VuduIVAUS'
The Cabin in the Woods	'Horror'	'iTunes', 'Amazon Instant Video', 'Google Play', 'Amazon Prime Video', 'Hulu', 'VuduIVAUS'
Antz	'Animation', 'Adventure', 'Comedy', 'Family'	'Amazon Instant Video', 'iTunes', 'Hulu', 'Google Play', 'VuduIVAUS'
Risky Business	'Comedy', 'Crime', 'Drama', 'Romance'	'VuduIVAUS', 'iTunes', 'Google Play', 'Amazon Instant Video', 'Hulu'
Mission: Impossible - Fallout	'Action', 'Adventure', 'Thriller'	'Amazon Instant Video', 'iTunes', 'Google Play', 'Amazon Prime Video', 'Hulu'
Star Trek II: The Wrath of Khan	'Action', 'Adventure', 'Sci-Fi'	'Amazon Instant Video', 'Google Play', 'iTunes', 'Hulu', 'VuduIVAUS'
The Great Escape	'Adventure', 'Drama', 'History', 'Thriller', 'War'	'iTunes', 'Google Play', 'Amazon Prime Video', 'Amazon Instant Video', 'VuduIVAUS'
The Last Black Man in San Francisco	'Drama'	'Amazon Instant Video', 'Google Play', 'Amazon Prime Video', 'iTunes'
The Report	'Biography', 'Crime', 'Drama', 'History', 'Thriller'	'Amazon Instant Video', 'Amazon Prime Video'
It's a Wonderful Life	'Drama', 'Family', 'Fantasy'	'iTunes', 'Google Play', 'Amazon Prime Video', 'Amazon Instant Video', 'VuduIVAUS'
Manchester by the Sea	'Drama'	'VuduIVAUS', 'iTunes', 'Amazon Prime Video', 'Google Play'
Lady Bird	'Comedy', 'Drama'	'Google Play', 'iTunes', 'Amazon Instant Video', 'VuduIVAUS', 'Netflix'
Midsommar	'Drama', 'Horror', 'Mystery', 'Thriller'	'Google Play', 'Amazon Instant Video', 'iTunes', 'Amazon Prime Video', 'VuduIVAUS'
Toy Story	'Animation', 'Adventure', 'Comedy', 'Family', 'Fantasy'	'iTunes', 'Amazon Instant Video', 'Google Play', 'Disney+'
Toy Story 2	'Animation', 'Adventure', 'Comedy', 'Family', 'Fantasy'	'iTunes', 'Google Play', 'Amazon Instant Video', 'Disney+'
Pinocchio	'Animation', 'Comedy', 'Family', 'Fantasy', 'Musical'	'iTunes', 'Amazon Instant Video', 'Google Play', 'Disney+', 'VuduIVAUS'
Mary Poppins	'Comedy', 'Family', 'Fantasy', 'Musical'	'iTunes', 'Amazon Instant Video', 'Google Play', 'Disney+', 'VuduIVAUS'
Finding Nemo	'Animation', 'Adventure', 'Comedy', 'Family'	'Google Play', 'iTunes', 'Amazon Instant Video', 'Disney+'
Inside Out	'Animation', 'Adventure', 'Comedy', 'Drama', 'Family', 'Fantasy'	'iTunes', 'Google Play', 'Amazon Instant Video', 'Disney+', 'PlutoIVAUS', 'VuduIVAUS'
Toy Story 3	'Animation', 'Adventure', 'Comedy', 'Family', 'Fantasy'	'Google Play', 'iTunes', 'Disney+', 'Amazon Instant Video'
Zootopia	'Animation', 'Adventure', 'Comedy', 'Crime', 'Family', 'Mystery'	'iTunes', 'Amazon Instant Video', 'Google Play', 'Disney+'
The Incredibles	'Animation', 'Action', 'Adventure', 'Family'	'iTunes', 'Amazon Instant Video', 'Google Play', 'Disney+'
Free Solo	'Documentary', 'Adventure', 'Sport'	'VuduIVAUS', 'iTunes', 'Google Play', 'Disney+', 'Hulu', 'Amazon Instant Video'
The Princess Bride	'Adventure', 'Family', 'Fantasy', 'Romance'	'VuduIVAUS', 'iTunes', 'Disney+', 'Amazon Instant Video', 'Google Play'
Ratatouille	'Animation', 'Adventure', 'Comedy', 'Drama', 'Family', 'Fantasy'	'iTunes', 'Amazon Instant Video', 'Google Play', 'Disney+'
Monsters, Inc.	'Animation', 'Adventure', 'Comedy', 'Family', 'Fantasy'	'iTunes', 'Google Play', 'Amazon Instant Video', 'Disney+'
Miracle on 34th Street	'Comedy', 'Drama', 'Family'	'iTunes', 'Amazon Instant Video', 'Google Play', 'Disney+', 'VuduIVAUS'
Moana	'Animation', 'Adventure', 'Comedy', 'Family', 'Fantasy', 'Musical'	'Amazon Instant Video', 'iTunes', 'Google Play', 'Disney+'
Iron Man	'Action', 'Adventure', 'Sci-Fi'	'iTunes', 'Amazon Instant Video', 'Google Play', 'Disney+', 'VuduIVAUS'
Avengers: Endgame	'Action', 'Adventure', 'Drama', 'Sci-Fi'	'VuduIVAUS', 'iTunes', 'Amazon Instant Video', 'Google Play', 'Disney+'
The Avengers	'Action', 'Adventure', 'Sci-Fi'	'VuduIVAUS', 'iTunes', 'Amazon Instant Video', 'Google Play', 'Amazon Prime Video', 'Disney+'
A Bug's Life	'Animation', 'Adventure', 'Comedy', 'Family'	'Google Play', 'iTunes', 'Amazon Instant Video', 'Disney+', 'VuduIVAUS'
Captain America: Civil War	'Action', 'Adventure', 'Sci-Fi'	'VuduIVAUS', 'iTunes', 'Amazon Instant Video', 'Google Play', 'Disney+'
Captain America: The Winter Soldier	'Action', 'Adventure', 'Sci-Fi', 'Thriller'	'VuduIVAUS', 'Google Play', 'iTunes', 'Amazon Instant Video', 'Disney+'
Doctor Strange	'Action', 'Adventure', 'Fantasy', 'Sci-Fi'	'Google Play', 'Amazon Instant Video', 'iTunes', 'Disney+', 'VuduIVAUS'